20 5 20 5
####################
#....#..<...#......#
#>..#........#.....#
#..#......<...#....#
###########.#.#.#.##